MHHHHHHHHHHHHHHHHHHHHHHHHHHH
HRHHHRHRRRHRRRHHRHHHHHRHHHHH
HHRHRHHRHHHRLLRHRHHHHRLRHHHH
HHHRHHHRRRHRRRHHRHHHRLLLRHHH
HHRHRHHRHHHRLLRHRHHRHRRRHRHH
HRHHHRHRRRHRRRHHRHRHHHHHHHRH
HHHHHHHHHHHHHHHHHHHHHHHHHHHH