RRRRRRRRRRHRRRRRRRRRR
RLLLLLRLLLLLLRLLRLLLR
RLRRRLRLRRRRLRLRRLRRR
RRRLRLLLRLLRLRLLLLRLR
RLLLRLRLRLRRLRRRRLLLR
RLRLRRRLLLLRLLLLRLRLR
RLRLLLLLRRRRRLRLRLRLR
RRRLRRRLRLLLLLRLRLRRR
RLLLRLLLRLRRRRRLLLLLR
RLRRRRRRRLRLLLRRRRRRR
RLLLRLLLRLRRLRRLLLLLR
RRRRRLRLLLLRLLLLRRRLR
RLLLRLRRRRLRRRLRRLRLR
RLRLRLRLLRLLLRLLRLLLR
RLRRRLRRLRRRRRRRRLRRR
RLLLLLLRLRLLLLLLRLLLR
RLRRRRRRLRRRLRRLRRRLR
RLRLLLLLLRLRLLRLLLLLR
RLRLRRLRRRLRRLRRRRLRR
RLLLRLLLLLLLLLLLRLLLR
RRRRRRRRRRMRRRRRRRRRR