RRRRRHHHHHRRRRRRRRRR
RLLLRLRRRHRRRHHRHRRR
LRLRLLRHHHRLRHHHHRLR
LLMLLLRRRHRRRRHRHRRR
LRLRLLRHHHRLLRHRHRHR
RLLLRLRRRHRRRRHRHRHR
RRRRRRRRRHHHHHHRHHHR