LLLRLLLLLLRRRRRLRLRRLLLLLRRLLLLLLRRRRRRRRRRLLLLRRRRLLLLLLLLLLLLL
LRLRLRRLRLLLLLLLRLRRLRRRLLLLRRRRLLLLLLLLLLLLRRLLLLRLRLLLLLLRRRRL
LRLLLRRLRRRLRRLRRLLLLRRRRRRRRRRRRRRRRRRRRRRRRRRRRLRLRLRRRRLRRRRL
LRRRRRRLLRRLLLLRRRRRRRLLLLLLLLLLLLLLLLLLLLLLLLLLLLRLRLLRRLLLLLLL
LLLLLLLLLRRRRRLRRRRRLLLRRRLRRRRRRRRRRRRRRRRRLRRRRRRLRRLRRLRRLRRR
LRRRRRRRLRRRRRLRRRRRLRRRRRLRLLLLLLLLLLLLLLLRLRRRRRRLRRLLLLRRLRRR
LLLRRRRRLRRRRRLLLLLLLLLLLLLRLRRRRRRRRRRRRRLRLLLLLLLLRRRRRRRRLRRR
RRLRRRRLLLLLLLLRRLRRRRLRRRLRLRLLLLLLLLLLLRLRLRRRRRRRRLLLLRRRLRRR
RRLLLLLLRRRRRRLRRLRRRRLRRRLRLRLRRRRRRRRRLRLRLRRRRLLLLLRRLRRRLRRR
RRLRRRRLRRRRRRLRRLLLRRLLLLLRLRLRLLLLLLLRLRLRLLLLLLRRRRRRLLLLLLLR
RRLRRRRLLLLLLLLRRRRLRRRRRRLRLRLRLRRRRRLRLRLRLRRRRLRRRRRRRRRRRRLR
RRLRRRRLRRRRRRLRRRRLRRRRRLLRLRLRLLLLRRLRLRLRLRRRRLLLLLLLLLRRRLLR
RRLLRRRLRRRRRRLLLLLLLLLLLLRRLRLRRRRLRRLRLRLRLLLLLLRRRRRRRLRRRLRR
RRRLRRRLRRRRRRLRRRRRRLRRRRLLLRLLLLLLRRLRLLLRLRRRRRRRRRRRRLLLLLRR
RRRLRRRLLLLLRRLRRRLLLLRRRRLRRRRRRRRRRRLRRRRRLRRRRRRRRRRRRLRRRRRR
LLLLLLRRRRRLLLLLLLLRRLRRRRLLLLLRLLLRRRLRRLLLLLLLLLLLLLLLLLRRRRRR
LRRLRLRRRRRRRRRRRLRRRLRRRRRRRRLRLRLRRRLRRLRRRRRRLRRLRRRRRLRRRRRR
LRRLRLRLLLLRRRRRRLRRRLRRRRRRRRLLLRLRRRLRRLRRRLLLLRRLRRRRRLRRRRRR
LRRLRLLLRRLRRRRRRLLLLLRRRRLLLLLRRRLRRRLRRLLRRLRRRRRLRRRRRLLLLRRR
LLLLRRRRRRLRRLLLLLRRRRRRRRLRRRRRRLLRRRLRRRLLLLRRLLLLRRRRRRRRLRRR
RLRLLRRLLLLRRLRRRRRRRRRRRRLRRRRRRLRRRRLRRRLRRRRRLRRLRRRRRRRRLLRR
RLRRLRRLRRRRRLRRRRRRRRRRRRLRRRRRRLLRRRLRRRLLLLLLLRRLRLLLRRRRRLRR
RLLRLRRLRRLLLLRRRRRRRRRLLLLRRRRRRRLRRRLRRRRRRRRRRRRLLLRLLLLLLLRR
RRLLLRRLRRLRRRRRRRRRRRRLRRRRRRRRRRLRRRLRRRRRRRRRRRRRRRRRRRRLRRRR
RRLRRRRLRRLRRLLLLLLLLLLLLLLLLLLLLLLRRRLLLLLLLLLLLLLLLLLLLLRLRRRR
RRLLLLRLLLLRRLRRRRRRRRRRRRRRRRRRRRRRRRRLRRRRRLRRRLRRRRRLRLRLLLRR
RRLRRLRRRRRRRLRRRRRRRLLLLLLLLLRRRRRRRRRLRRRRRLLLLLRRRLLLRLRRRLRR
RRLRRLLLLLRRRLRRRLLLRLRRRRLRRLRRRRRLLLLLRRRRRLRRRRRRRLRRRLRRRLRR
RRLRRRRRRLRRRLLLLLRLRLRRRRLRLLRRRRLLRRRRRRRRRLLLLLLLLLLLRLRRRLRR
RRLLLLLLLLRRRRRRRRRLLLRRRRLRLRRRRRLRRRLLLLLLLLRRRRRRRRRLRLRRRLRR
RRRRRRRRRRRRRRRRRRRRRRRRRRLRLRRRRRLRRRLRRLRRRLRRRRLLLLRLLLRRRLLL
LLLLRRLLLLLLLLLLLLLLLLLLLLLRLRRRRRLLLLLRRLRRRLRRRRLRRLRRLRRRRRRL
RRRLRRLRRRRRRRLRRRRRRRRRLRRRLRRRRRLRRRRRRLRRRLLLLLLRRLRRLRRLLLLL
LLLLRRLRRRRRRRLRLLLLRRRRLRRLLRRRRRLLLLLLLLRRRLRRRRRRRLLLLRRLRRRL
LRRRRRLLLLLLLRLRLRRLLLLLLRRLRRRRRRLRRRRLRRRRRLRRRRRRRLRRLRRLRRRL
LLLRRRRRRRRRLRLRLRRRRRRRRRRLRRRRRRLRRRRLRRRRRLRRRRRRRLRRLLLLRRRL
LRLLRRRRRRRRLRLRLLLRRRRRLLLLRRRRRRLRRRRLLLLLLLLLLLLLLLRRRLRRRRRL
LRRLRRRRRLLLLRLRRRLRRRRRLRRRRRRLLLLRRRRRRRRRRRRRRLRRRLRRRLRRLLLL
LRRLLLLRRLRRRRLRRRLRLLLRLRLLRRRLRRRRRRRRRRRRRRRRRLRRRLLLLLRRLRRR
LRRLRRLRRLRRRRLLLLLRLRLRLRRLRRRLRRRRRRRRRRRRRRRRRLLLLLRRRRRRLRRR
LRRLRRLRRLRRRRRRRRRRLRLRLRRLRRRLRRRRLLLLLLLLLLLLLLRRRRRRRLLLLRRR
LRRLRRLLRLLLLLLLLLLLLRLRLRRLRRRLRRRRLRRRRLRRRRRRRLRRRRRRRLRRLRRR
LLLLRRRLRRRRRRRRRRRRRRLRLRRLRRRLLLLLLRRRRLRRLLLLLLLLLLRRLLLLLRRR
RRRLRRRLLLRRRRRRRRRRRRLRRRRLRRRLRRRRLLLLLLLLLRRRRRRRRLLLLRRRRRRR
RRRLRRRRRLLLLLLLLLLLLLLLLLLLRRRLLRRRRRRRRLRRLLLLLRRRRLRRLLLRRRRR
RRRLRRRRRLRRRRRRLRRRRRRRRRRRRRRRLRRRRLLLLLRRLRRRLRRRRLRRRRLLRRRR
RRRLLLLLLLRRRRLLLRRRRRRRRRRRRRRRLRRRRLRRRLLLLRRRLRRRRLRRRRRLRRRR
RRRLRRRRRLRRRRLRRRRRRRRRRRRLLLLLLLLRRLRRRRRLRRRRLLLLLLLLLLLLRRRR
RRRLRRRRRLLLLLLRRRRRRLLLLLLLRLRRRRLLLLRRRRRLRRRRLRRRRRRRRRRLRRRR
LLLLRRRRRRRRRLRRRLLLLLRRRRRLRLRRRRLRRLLLLLLLLLLLLRRRRRRRRRRLRRRR
RLRRRRRRRRRRRLRRRLRRRLRRRRRLRLRRRRLRRRRRRRRRRRRRLRRRRRRRRRRLLLLR
RLRRLLLRRRRRRLRRRLLLLLLLLLLLRLLLLLLRRRRRRRRLLLLRLLLLLLLLLLLLRRLR
RLRRLRLRLLLLLLRRRLRRRLRRRRRRRLRRRRLLLLLLLRRLRRLRRRRRLRRRLRRLRRLR
RLLRLRLRLRRRRRRRRLRRRLRRLLLLLLLRRRLRRRRRLLLLRLLLLLLRLRRRLRRLRRLR
RRLRLRLRLRRRRRRLLLRRRLLLLRRRRRLRRRLLLLLLLRRRRLRRRRLRLRRRLLLLRRLR
RRLRLRLLLRRRRRLLRLRRRRRRLRRRRRLRRRLRRRRRLRRRRLRRLLLLLRRLLRRLLLLL
RLLRLRRRRRRLLLLRRLLLLLLLLLLLLLLRRRLRRRLLLRRRRLLLLRRRLRRLRRRRRRRL
RLRRLRRRRRRLRRRRRLRRRRRRRLRRLRRRLLLRLLLRRRRLLLRRLLLLLRLLRRRRRRRL
RLRRLLLLRRRLRRRRRLRRRRRLLLRRLRRRLRRRLRRRLLLLRRRRLRRRRRLRRLLLLLRL
RLLRRRRLRRRLRRRRRLRRLLLLRRRRLLLLLRRRLRLLLRRRRLLLLRRRRRLRLLRRRLRL
RRRRRRRLRRRLRRLLLLLLLRRLRRRRRRRRLRRRLLLRLRRRRLRRRRRRRRLRLRRRRLRL
RLLLLLLLRRRLRRLRRRRRLRRLLLLLRRRRLRRRRRRRLRLLLLRRRRLLLLLLLRRLLLRR
HHRRRRRRRRRLRRLRRRRRLRRRRRRLLLLLLRRRRRRRLLLRRLRRRRLRRRRRRRRLRRRR
HHRRRRRRRLLLLLLRRRRRLRRRRRRRRRRRRRRRRRRRRRRRRLLLLLLRRRRRRRRLLLLM